11111111111111111111111111
10000000000000000000000001
10000200000000000000022221
10000000000000000000000001
10000300000000000000030301
10000000000000040400033331
10000400000000040400000001
10000000000000044400000001
11111111111111111111111111
