11111111111111111
10000000100000001
11111000110000101
10101000100000101
10101000000000101
10000000000000001
11111111111111111
