111111111111111111111111111111111111111111111111111111111111111111111111
100000000000000000000000000000000000000000000000000000000000000000000001
100000000000000000000000000000000000000000000000000000000000000000000001
100000000000000000000000000000000000000000000000000000000000000000000001
100000000000000000011000000000000000000000000000000000000000000000000001
100000000000000000011000000000000000000000000000000000000000000000000001
100000000000000000011000000000000000000000000000000000000011111100000001
100000000000000000011000000000000000000000000000000000000000000100000001
100000000000001111111000000000000000000000000001111111110000110100000001
100000000000001111111000000000000000000000000001100000000000000100000001
100000000000000000000000000000000000000000000011100000000111111100000001
100000000000000000001110011100000000000000000111100000000000000000000001
100000000000000000001000000100000000000000011111100000000000000000000001
100000000000000000001000000100000000000000111111100000000000000000000001
100000000000000000001000000100000000000001111111100000000000000000000001
100000000000000000001111111100000000000011111111100000000000000000000001
100000000000000000000000000000000000000000000000000000000000000000000001
100000000000000000000000000000000000000000000000000000000000000000000001
100000000000000000000000000000000000000000000000000000000000000000000001
111111111111111111111111111111111111111111111111111111111111111111111111
