11111111111111111111111111111111111111111111111111111111111111111
11111111111111111111111111111111111111111111111111111111111111111
11111111111111111111111111111111111111111111111111111111111111111
11111111111111111111111111111111111111111111111111111111111111111
11111111111111111111111111111111111111111111111111111111111111111
11111111110000000000000000000000000000000000000000000000000011111
11111111110000000000000000000000000000000000000000000000000011111
11111111110000000000000000000000000000000000000000000000000011111
11111111110000000000000000000000000000000000000000000000000011111
11111111110000000000000000000000000000000000000000000000000011111
11111000000000000000000000000000001111100000000000000000000011111
11111000000000000000000000000000001111100000000000000000000011111
11111000000000000000000000000000001111100000000000000000000011111
11111000000000000000000000000000001111100000000000000000000011111
11111000000000000000000000000000001111100000000000000000000011111
11111111111111100000000000000000001111100000000000000000000011111
11111111111111100000000000000000001111100000000000000000000011111
11111111111111100000000000000000001111100000000000000000000011111
11111111111111100000000000000000001111100000000000000000000011111
11111111111111100000000000000000001111100000000000000000000011111
11111000001111100000000000000000000000000000000000000000000011111
11111000001111100000000000000000000000000000000000000000000011111
11111000001111100000000000000000000000000000000000000000000011111
11111000001111100000000000000000000000000000000000000000000011111
11111000001111100000000000000000000000000000000000000000000011111
11111000000000000000000000000000000000000000000000000000000011111
11111000000000000000000000000000000000000000000000000000000011111
11111000000000000000000000000000000000000000000000000000000011111
11111000000000000000000000000000000000000000000000000000000011111
11111000000000000000000000000000000000000000000000000000000011111
11111111111111111111111111111111111111111111111111111111111111111
11111111111111111111111111111111111111111111111111111111111111111
11111111111111111111111111111111111111111111111111111111111111111
11111111111111111111111111111111111111111111111111111111111111111
11111111111111111111111111111111111111111111111111111111111111111
