1111111111111111
1000000001001001
1001111001001001
1001000000000001
1111001111111111
1000000000000001
1001001111001111
1001001001001001
1001001001111001
1001000000000001
1111111111111131
